###############################
#                             #
#.......###########    ...    #
#                             #
# ###########.....#############
#.........                    #
#############....##############
#.                            #
###############################